1111111111
1000E00001
10C0000001
1000P10001
1000011001
1111111111