11111111111111111111
1CC0E000000C10000101
10C000000000000C0001
10000100000100010101
10CC01100C10001C0011
10CC01100C00001CP011
10CC01100C00001C0011
10CC01100C00001C0011
10CC01100C10001C0011
10CC01100C10001C0011
11111111111111111111