11111111
1C110001
101C00C1
1P001101
10E000C1
11111111