11111111
1E11S001
101C00C1
1P001101
1SC000M1
11111111