111111
100001
1000C1
1P0001
10E001
111111