11111111
1E110001
101C00C1
1P001101
10C00001
11111111