11111111111111111111
1CC0E000000C10000101
10C0000000000C0C0001
10000100000100010101
10CC01100C10001C0011
10001000101CC0010011
10000100000100010101
1CC0000P000C10000101
11111111111111111111