1111111111111111111111
1000000000000000000001
1000001000000000000001
100001E100000000000001
1000000000000000000001
1000000000000000000001
100000000000000P000001
1000M00000000000000001
100000000C000000000001
1000000000000000000001
1111111111111111111111